//MAP CONVERTED BY dmm2tgm.py THIS HEADER COMMENT PREVENTS RECONVERSION, DO NOT REMOVE
"aa" = (
/turf/closed/wall/r_wall/prison_unmeltable,
/area/prison/research/secret/WYLab)
"aN" = (
/obj/structure/machinery/big_computers/science_big/operator_machine,
/obj/structure/window/reinforced{
	dir = 1;
	layer = 2
	},
/turf/open/floor/almayer/blackfull/west,
/area/prison/research/secret/WYLab)
"aT" = (
/obj/structure/cable/white{
	color = "#550d0d";
	icon_state = "5-6";
	layer = 5;
	level = 2
	},
/mob/living/simple_animal/mouse/rat/white/Milky,
/turf/open/floor/hybrisa/misc/wysmallright,
/area/prison/research/secret/WYLab)
"bJ" = (
/obj/effect/decal/warning_stripes{
	icon_state = "N";
	pixel_y = 2
	},
/obj/effect/decal/warning_stripes{
	icon_state = "S"
	},
/obj/item/clothing/glasses/science,
/turf/open/floor/hybrisa/tile/tilewhite,
/area/prison/research/secret/WYLab)
"bZ" = (
/obj/structure/prop/hybrisa/xenobiology/small/hugger,
/turf/open/floor/almayer/blackfull/west,
/area/prison/research/secret/WYLab)
"el" = (
/obj/structure/machinery/big_computers/computerwhite/computer4,
/obj/structure/window/reinforced{
	dir = 8
	},
/obj/structure/window/reinforced{
	dir = 1;
	layer = 2
	},
/turf/open/floor/almayer/blackfull/west,
/area/prison/research/secret/WYLab)
"ev" = (
/obj/item/paper/crumpled{
	pixel_x = 15;
	pixel_y = -9
	},
/obj/effect/decal/cleanable/blood,
/turf/open/floor/hybrisa/misc/wysmallleft,
/area/prison/research/secret/WYLab)
"go" = (
/obj/structure/surface/table/reinforced/prison,
/obj/structure/machinery/centrifuge{
	pixel_y = 8;
	pixel_x = -2
	},
/obj/structure/machinery/light/small/blue{
	dir = 1
	},
/obj/structure/sign/poster/corporate{
	pixel_y = 32
	},
/turf/open/floor/almayer/blackfull/west,
/area/prison/research/secret/WYLab)
"ho" = (
/obj/structure/machinery/autodispenser,
/turf/open/floor/almayer/blackfull/west,
/area/prison/research/secret/WYLab)
"iw" = (
/obj/effect/decal/warning_stripes{
	icon_state = "N";
	pixel_y = 2
	},
/obj/effect/decal/warning_stripes{
	icon_state = "S"
	},
/turf/open/floor/hybrisa/tile/tilewhite,
/area/prison/research/secret/WYLab)
"jf" = (
/obj/item/tool/kitchen/tray{
	pixel_y = 8
	},
/obj/item/weed_extract{
	pixel_y = 6
	},
/obj/item/weed_extract{
	pixel_x = 6;
	pixel_y = 8
	},
/obj/item/weed_extract{
	pixel_x = -6;
	pixel_y = 7
	},
/obj/structure/platform/metal/almayer/north{
	layer = 1.9
	},
/obj/structure/surface/table/reinforced/prison,
/obj/structure/window/reinforced,
/turf/open/floor/almayer/blackfull/west,
/area/prison/research/secret/WYLab)
"jv" = (
/turf/open/space/basic,
/area/space)
"kg" = (
/obj/effect/decal/warning_stripes{
	icon_state = "E";
	layer = 3.33
	},
/obj/effect/decal/warning_stripes{
	icon_state = "W"
	},
/obj/item/shard,
/turf/open/floor/hybrisa/tile/tilewhite,
/area/prison/research/secret/WYLab)
"kz" = (
/obj/effect/decal/warning_stripes{
	icon_state = "E";
	layer = 3.33
	},
/obj/effect/decal/warning_stripes{
	icon_state = "W"
	},
/obj/effect/decal/strata_decals/grime/grime4{
	dir = 4
	},
/turf/open/floor/hybrisa/tile/tilewhite,
/area/prison/research/secret/WYLab)
"lv" = (
/obj/structure/surface/table/reinforced/prison,
/obj/item/paper_bin{
	pixel_x = -3;
	pixel_y = 9
	},
/obj/item/paper/crumpled{
	pixel_x = 15;
	pixel_y = -9
	},
/obj/item/tool/stamp/rd,
/obj/item/tool/pen{
	pixel_x = -4;
	pixel_y = 6
	},
/obj/effect/spawner/random/goggles,
/turf/open/floor/almayer/blackfull/west,
/area/prison/research/secret/WYLab)
"lI" = (
/obj/effect/decal/warning_stripes{
	icon_state = "N";
	pixel_y = 2
	},
/obj/effect/decal/warning_stripes{
	icon_state = "S"
	},
/obj/structure/cable/white{
	color = "#007740";
	icon_state = "8-9";
	layer = 5;
	level = 2
	},
/turf/open/floor/hybrisa/tile/tilewhite,
/area/prison/research/secret/WYLab)
"md" = (
/obj/structure/window/reinforced,
/turf/open/floor/almayer/blackfull/west,
/area/prison/research/secret/WYLab)
"ne" = (
/obj/structure/window/framed/prison/reinforced,
/obj/structure/machinery/door/poddoor/almayer/blended/white{
	id = "fiorina_wy_labs_lockdown";
	name = "Biohazard Containment Airlock"
	},
/turf/open/floor/plating/prison,
/area/prison/research/secret/WYLab)
"ow" = (
/obj/structure/machinery/big_computers/science_big/synthesis_simulator,
/obj/structure/window/reinforced,
/obj/structure/window/reinforced{
	dir = 8
	},
/turf/open/floor/almayer/blackfull/west,
/area/prison/research/secret/WYLab)
"pD" = (
/obj/effect/decal/warning_stripes{
	icon_state = "W"
	},
/obj/effect/decal/warning_stripes{
	icon_state = "N";
	pixel_y = 2
	},
/obj/item/shard,
/obj/item/prop/alien/hugger{
	pixel_x = -7;
	pixel_y = -5
	},
/obj/item/clothing/head/bio_hood/wy_bio/alt,
/turf/open/floor/hybrisa/tile/tilewhite,
/area/prison/research/secret/WYLab)
"qj" = (
/turf/closed/wall/r_wall/prison_unmeltable,
/area/space)
"rr" = (
/obj/structure/machinery/computer/disk_reader{
	dir = 8
	},
/obj/structure/surface/table/reinforced/prison,
/obj/structure/machinery/door_control{
	pixel_y = 11;
	pixel_x = -7;
	id = "fiorina_wy_labs_lockdown"
	},
/turf/open/floor/almayer/blackfull/west,
/area/prison/research/secret/WYLab)
"rT" = (
/obj/structure/window/reinforced,
/obj/structure/window/reinforced{
	dir = 4
	},
/turf/open/floor/almayer/blackfull/west,
/area/prison/research/secret/WYLab)
"ug" = (
/obj/effect/decal/warning_stripes{
	icon_state = "S"
	},
/turf/open/floor/prison/whitered/north,
/area/prison/research/secret/testing)
"ut" = (
/turf/open/floor/almayer/blackfull/west,
/area/prison/research/secret/WYLab)
"ux" = (
/obj/structure/cable/white{
	color = "#9f8700";
	icon_state = "8-9";
	layer = 5;
	level = 2
	},
/obj/effect/decal/warning_stripes{
	icon_state = "N";
	pixel_y = 2
	},
/obj/effect/decal/warning_stripes{
	icon_state = "S"
	},
/turf/open/floor/hybrisa/tile/tilewhite,
/area/prison/research/secret/WYLab)
"uV" = (
/obj/structure/cable/white{
	color = "#550d0d";
	icon_state = "8-10";
	layer = 5;
	level = 2
	},
/obj/structure/window/reinforced{
	dir = 4
	},
/obj/structure/window/reinforced{
	dir = 1;
	layer = 2
	},
/obj/structure/prop/hybrisa/xenobiology/small/larva,
/turf/open/floor/almayer/blackfull/west,
/area/prison/research/secret/WYLab)
"vE" = (
/obj/structure/cable/white{
	color = "#9f8700";
	icon_state = "4-6";
	layer = 5;
	level = 2
	},
/obj/effect/decal/warning_stripes{
	icon_state = "N";
	pixel_y = 2
	},
/obj/effect/decal/warning_stripes{
	icon_state = "S"
	},
/turf/open/floor/hybrisa/tile/tilewhite,
/area/prison/research/secret/WYLab)
"wg" = (
/obj/effect/decal/warning_stripes{
	icon_state = "N";
	pixel_y = 2
	},
/obj/effect/decal/warning_stripes{
	icon_state = "S"
	},
/obj/effect/decal/strata_decals/grime/grime4{
	dir = 4
	},
/turf/open/floor/hybrisa/tile/tilewhite,
/area/prison/research/secret/WYLab)
"ws" = (
/obj/structure/machinery/big_computers/science_big/medilathe,
/obj/structure/window/reinforced,
/turf/open/floor/almayer/blackfull/west,
/area/prison/research/secret/WYLab)
"xX" = (
/obj/effect/decal/warning_stripes{
	icon_state = "N";
	pixel_y = 2
	},
/obj/effect/decal/warning_stripes{
	icon_state = "E";
	layer = 3.33
	},
/turf/open/floor/hybrisa/tile/tilewhite,
/area/prison/research/secret/WYLab)
"yp" = (
/obj/effect/decal/warning_stripes{
	icon_state = "N";
	pixel_y = 2
	},
/obj/effect/decal/warning_stripes{
	icon_state = "S"
	},
/obj/structure/cable/white{
	color = "#007740";
	icon_state = "1-4";
	layer = 5;
	level = 2
	},
/turf/open/floor/hybrisa/tile/tilewhite,
/area/prison/research/secret/WYLab)
"zo" = (
/obj/effect/decal/warning_stripes{
	icon_state = "S"
	},
/obj/effect/decal/hybrisa/workers_decal{
	pixel_x = 1;
	color = "#32332d";
	pixel_y = 1
	},
/turf/open/floor/prison/whitered/north,
/area/prison/research/secret/testing)
"AG" = (
/obj/effect/decal/strata_decals/grime/grime4{
	dir = 4
	},
/turf/open/floor/almayer/blackfull/west,
/area/prison/research/secret/WYLab)
"BM" = (
/obj/structure/prop/hybrisa/xenobiology/small/offempty,
/turf/open/floor/almayer/blackfull/west,
/area/prison/research/secret/WYLab)
"Cm" = (
/obj/structure/machinery/big_computers/computerwhite/computer3,
/turf/open/floor/almayer/blackfull/west,
/area/prison/research/secret/WYLab)
"Cu" = (
/obj/effect/decal/warning_stripes{
	icon_state = "W"
	},
/obj/effect/decal/warning_stripes{
	icon_state = "E";
	layer = 3.33
	},
/obj/structure/bed/chair/office/dark{
	dir = 4;
	pixel_x = 7;
	pixel_y = 10
	},
/turf/open/floor/hybrisa/tile/tilewhite,
/area/prison/research/secret/WYLab)
"CV" = (
/obj/effect/decal/warning_stripes{
	icon_state = "N"
	},
/obj/structure/machinery/door/airlock/multi_tile/hybrisa/personal_solid_white/autoname,
/obj/structure/machinery/door/poddoor/almayer/blended/white{
	id = "fiorina_wy_labs_lockdown";
	name = "Biohazard Containment Airlock"
	},
/turf/open/floor/plating/prison,
/area/prison/research/secret/WYLab)
"Df" = (
/obj/effect/decal/warning_stripes{
	icon_state = "N";
	pixel_y = 2
	},
/obj/effect/decal/warning_stripes{
	icon_state = "S"
	},
/obj/effect/decal/strata_decals/grime/grime4{
	dir = 4
	},
/obj/item/shard,
/turf/open/floor/hybrisa/tile/tilewhite,
/area/prison/research/secret/WYLab)
"DZ" = (
/turf/open_space,
/area/space)
"Fp" = (
/obj/structure/prop/hybrisa/xenobiology/small/larva,
/turf/open/floor/almayer/blackfull/west,
/area/prison/research/secret/WYLab)
"FX" = (
/obj/structure/surface/table/reinforced/prison,
/obj/item/clipboard,
/obj/item/paper,
/obj/item/paper{
	layer = 5;
	pixel_x = -7;
	pixel_y = 7
	},
/obj/effect/landmark/objective_landmark/science,
/obj/structure/machinery/power/apc/power/east,
/turf/open/floor/almayer/blackfull/west,
/area/prison/research/secret/WYLab)
"GQ" = (
/turf/closed/wall/r_wall/prison_unmeltable,
/area/prison/research/secret/testing)
"GV" = (
/obj/effect/decal/warning_stripes{
	icon_state = "N"
	},
/obj/structure/machinery/door/poddoor/almayer/blended/white{
	id = "fiorina_wy_labs_lockdown";
	name = "Biohazard Containment Airlock"
	},
/turf/open/floor/plating/prison,
/area/prison/research/secret/WYLab)
"Ha" = (
/obj/structure/surface/table/reinforced/prison,
/obj/structure/machinery/reagent_analyzer{
	pixel_y = 6
	},
/obj/structure/prop/hybrisa/misc/metergreen{
	pixel_y = 36
	},
/turf/open/floor/almayer/blackfull/west,
/area/prison/research/secret/WYLab)
"Ie" = (
/turf/open/space,
/area/space)
"Jt" = (
/obj/effect/decal/warning_stripes{
	icon_state = "W"
	},
/obj/effect/decal/warning_stripes{
	icon_state = "S"
	},
/obj/effect/decal/cleanable/blood,
/turf/open/floor/hybrisa/tile/tilewhite,
/area/prison/research/secret/WYLab)
"LB" = (
/obj/structure/machinery/big_computers/science_big/protolathe,
/obj/structure/prop/hybrisa/misc/redmeter{
	pixel_y = 32
	},
/turf/open/floor/almayer/blackfull/west,
/area/prison/research/secret/WYLab)
"Mh" = (
/obj/structure/reagent_dispensers/watertank,
/obj/effect/decal/warning_stripes{
	icon_state = "S"
	},
/turf/open/floor/prison/whitered/northeast,
/area/prison/research/secret/testing)
"Mw" = (
/obj/item/tool/kitchen/tray,
/obj/item/stack/sheet/xenochitin{
	pixel_y = 12
	},
/obj/item/tool/kitchen/tray{
	pixel_y = 13
	},
/obj/structure/surface/table/reinforced/prison,
/obj/item/stack/sheet/xenochitin,
/turf/open/floor/almayer/blackfull/west,
/area/prison/research/secret/WYLab)
"Os" = (
/obj/effect/decal/warning_stripes{
	icon_state = "E";
	layer = 3.33
	},
/obj/effect/decal/warning_stripes{
	icon_state = "W"
	},
/turf/open/floor/hybrisa/tile/tilewhite,
/area/prison/research/secret/WYLab)
"Rg" = (
/obj/effect/decal/warning_stripes{
	icon_state = "S"
	},
/obj/effect/decal/warning_stripes{
	icon_state = "W"
	},
/obj/structure/machinery/light/double/blue{
	dir = 8;
	pixel_x = -10
	},
/turf/open/floor/prison/whitered/northwest,
/area/prison/research/secret/testing)
"Ry" = (
/obj/structure/machinery/light/small/blue{
	dir = 1
	},
/obj/effect/decal/strata_decals/grime/grime4{
	dir = 4
	},
/obj/effect/landmark/objective_landmark/science,
/obj/structure/sign/poster/wylogo{
	pixel_y = 32;
	layer = 2.9
	},
/obj/structure/prop/hybrisa/xenobiology/small/cracked1,
/obj/item/shard,
/turf/open/floor/almayer/blackfull/west,
/area/prison/research/secret/WYLab)
"Wq" = (
/obj/structure/surface/table/reinforced/prison,
/obj/structure/machinery/r_n_d/organic_analyzer{
	pixel_y = 9;
	pixel_x = -3
	},
/turf/open/floor/almayer/blackfull/west,
/area/prison/research/secret/WYLab)
"XY" = (
/obj/effect/decal/warning_stripes{
	icon_state = "E";
	layer = 3.33
	},
/obj/effect/decal/warning_stripes{
	icon_state = "S"
	},
/obj/item/paper/crumpled{
	pixel_x = 15;
	pixel_y = -9
	},
/turf/open/floor/hybrisa/tile/tilewhite,
/area/prison/research/secret/WYLab)
"Yk" = (
/obj/structure/cable/white{
	color = "#9f8700";
	icon_state = "8-9";
	layer = 5;
	level = 2
	},
/obj/structure/window/reinforced{
	dir = 1;
	layer = 2
	},
/obj/effect/spawner/random/pills,
/turf/open/floor/almayer/blackfull/west,
/area/prison/research/secret/WYLab)

(1,1,1) = {"
Ie
aa
aa
aa
aa
aa
aa
aa
GQ
"}
(2,1,1) = {"
aa
aa
Ry
BM
bZ
Fp
BM
ne
Rg
"}
(3,1,1) = {"
aa
Cm
pD
kg
Os
Os
Jt
ne
ug
"}
(4,1,1) = {"
aa
LB
Df
el
AG
ow
bJ
ne
ug
"}
(5,1,1) = {"
aa
ut
vE
aN
ev
md
yp
CV
zo
"}
(6,1,1) = {"
aa
Wq
ux
Yk
aT
ws
lI
GV
ug
"}
(7,1,1) = {"
aa
Ha
iw
uV
ut
rT
wg
ne
ug
"}
(8,1,1) = {"
aa
go
xX
kz
Os
Cu
XY
ne
ug
"}
(9,1,1) = {"
aa
ho
Mw
jf
lv
rr
FX
ne
Mh
"}

(1,1,2) = {"
jv
DZ
qj
qj
qj
qj
qj
qj
qj
"}
(2,1,2) = {"
jv
qj
qj
qj
qj
qj
qj
qj
qj
"}
(3,1,2) = {"
jv
qj
qj
qj
qj
qj
qj
qj
qj
"}
(4,1,2) = {"
jv
qj
qj
qj
qj
qj
qj
qj
qj
"}
(5,1,2) = {"
jv
qj
qj
qj
qj
qj
qj
qj
qj
"}
(6,1,2) = {"
jv
qj
qj
qj
qj
qj
qj
qj
qj
"}
(7,1,2) = {"
jv
qj
qj
qj
qj
qj
qj
qj
qj
"}
(8,1,2) = {"
jv
qj
qj
qj
qj
qj
qj
qj
qj
"}
(9,1,2) = {"
jv
qj
qj
qj
qj
qj
qj
qj
qj
"}
