//MAP CONVERTED BY dmm2tgm.py THIS HEADER COMMENT PREVENTS RECONVERSION, DO NOT REMOVE
"aa" = (
/obj/structure/interior_wall/apc{
	icon_state = "rear_6"
	},
/turf/open/void/vehicle,
/area/space)
"ab" = (
/obj/structure/interior_wall/apc{
	icon_state = "wheel_back_top_1";
	pixel_x = -4;
	pixel_y = -4
	},
/turf/open/void/vehicle,
/area/space)
"ac" = (
/obj/structure/interior_wall/apc{
	icon_state = "corner_small_L";
	opacity = 0
	},
/obj/structure/interior_wall/apc{
	icon_state = "wheel_back_top_2";
	pixel_x = -4;
	pixel_y = -4
	},
/turf/open/void/vehicle,
/area/space)
"ad" = (
/obj/structure/interior_wall/apc{
	icon_state = "wall"
	},
/turf/open/void/vehicle,
/area/space)
"ae" = (
/obj/structure/bed/chair/vehicle{
	dir = 4;
	pixel_y = 16;
	pixel_x = -2
	},
/obj/structure/bed/chair/vehicle{
	dir = 4;
	pixel_x = -2
	},
/turf/open/shuttle/vehicle/floor_3_13,
/area/interior/vehicle/apc)
"ag" = (
/obj/structure/interior_wall/apc{
	icon_state = "door_back"
	},
/turf/open/space/basic,
/area/space)
"ah" = (
/obj/structure/interior_wall/apc{
	icon_state = "wheel_front_top_1";
	pixel_x = 1;
	pixel_y = -4
	},
/turf/open/void/vehicle,
/area/space)
"ai" = (
/obj/structure/interior_wall/apc{
	icon_state = "front_6"
	},
/turf/open/void/vehicle,
/area/space)
"aj" = (
/obj/structure/interior_wall/apc{
	icon_state = "corner_small_L"
	},
/obj/structure/interior_wall/apc{
	icon_state = "rear_5"
	},
/turf/open/void/vehicle,
/area/space)
"ak" = (
/obj/structure/interior_wall/apc{
	icon_state = "wall";
	opacity = 0
	},
/turf/open/void/vehicle,
/area/space)
"al" = (
/obj/structure/interior_wall/apc{
	icon_state = "corner_inverse_L";
	opacity = 0
	},
/turf/open/void/vehicle,
/area/space)
"am" = (
/obj/structure/vehicle_locker{
	pixel_y = 28;
	pixel_x = 6
	},
/obj/effect/landmark/interior/spawn/vehicle_gunner_seat/armor{
	dir = 4
	},
/turf/open/shuttle/vehicle/floor_3_8_1,
/area/interior/vehicle/apc)
"an" = (
/obj/structure/interior_wall/apc{
	icon_state = "corner_inverse_R";
	opacity = 0
	},
/turf/open/void/vehicle,
/area/space)
"ao" = (
/obj/structure/interior_wall/apc{
	icon_state = "corner_small_R"
	},
/obj/structure/interior_wall/apc{
	icon_state = "front_5"
	},
/turf/open/void/vehicle,
/area/space)
"ap" = (
/obj/structure/interior_wall/apc{
	icon_state = "rear_4"
	},
/turf/open/void/vehicle,
/area/space)
"aq" = (
/obj/structure/interior_wall/apc{
	icon_state = "front_4"
	},
/turf/open/void/vehicle,
/area/space)
"ar" = (
/obj/structure/interior_wall/apc{
	icon_state = "rear_3"
	},
/turf/open/void/vehicle,
/area/space)
"as" = (
/obj/structure/interior_wall/apc{
	icon_state = "front_3"
	},
/turf/open/void/vehicle,
/area/space)
"at" = (
/obj/structure/interior_wall/apc{
	icon_state = "rear_2"
	},
/turf/open/void/vehicle,
/area/space)
"au" = (
/obj/structure/interior_wall/apc{
	icon_state = "front_2"
	},
/turf/open/void/vehicle,
/area/space)
"av" = (
/obj/structure/interior_wall/apc{
	icon_state = "rear_1"
	},
/turf/open/void/vehicle,
/area/space)
"aw" = (
/obj/structure/interior_wall/apc{
	icon_state = "rear_wheel_L"
	},
/turf/open/space/basic,
/area/space)
"ax" = (
/obj/structure/interior_wall/apc{
	icon_state = "rear_wheel_R";
	opacity = 0
	},
/turf/open/space/basic,
/area/space)
"ay" = (
/turf/open/shuttle/vehicle/floor_1_13,
/area/interior/vehicle/apc)
"az" = (
/obj/effect/landmark/interior/spawn/interior_camera{
	dir = 10;
	pixel_x = -14;
	pixel_y = 38
	},
/obj/structure/bed/chair/vehicle{
	dir = 4;
	pixel_y = 16;
	pixel_x = -2
	},
/obj/structure/bed/chair/vehicle{
	dir = 4;
	pixel_x = -2
	},
/turf/open/shuttle/vehicle/floor_3_10_1,
/area/interior/vehicle/apc)
"aA" = (
/obj/structure/interior_wall/apc{
	icon_state = "front_wheel_L";
	opacity = 0
	},
/turf/open/space/basic,
/area/space)
"aB" = (
/obj/structure/interior_wall/apc{
	icon_state = "front_wheel_R"
	},
/turf/open/space/basic,
/area/space)
"aC" = (
/obj/structure/interior_wall/apc{
	icon_state = "front_1"
	},
/turf/open/void/vehicle,
/area/space)
"aD" = (
/turf/open/void/vehicle,
/area/space)
"aE" = (
/obj/structure/extinguisher_cabinet/lifeboat{
	icon = 'icons/obj/vehicles/interiors/general.dmi';
	pixel_x = 22;
	pixel_y = 28
	},
/obj/structure/machinery/cm_vending/sorted/vehicle_supply{
	pixel_y = 24
	},
/turf/open/shuttle/vehicle/floor_3_13,
/area/interior/vehicle/apc)
"aF" = (
/obj/structure/surface/table/reinforced/toc/west{
	pixel_y = 4;
	density = 0
	},
/obj/structure/machinery/computer/overwatch/toc{
	pixel_y = 24;
	layer = 2.97;
	density = 0
	},
/obj/structure/machinery/computer/groundside_operations/toc{
	pixel_x = 7;
	pixel_y = 24
	},
/turf/open/shuttle/vehicle/floor_3_7_1,
/area/interior/vehicle/apc)
"aH" = (
/obj/effect/landmark/interior/spawn/weapons_loader,
/obj/structure/prop/ice_colony/hula_girl{
	pixel_x = 8;
	pixel_y = 11;
	layer = 3.1
	},
/turf/open/shuttle/vehicle/floor_3_6,
/area/interior/vehicle/apc)
"aK" = (
/obj/effect/landmark/interior/spawn/interior_viewport{
	pixel_x = -6;
	pixel_y = 23
	},
/obj/structure/machinery/optable,
/turf/open/shuttle/vehicle/med,
/area/interior/vehicle/apc)
"aL" = (
/obj/structure/machinery/cm_vending/sorted/medical/blood/vehicle{
	pixel_x = -20;
	pixel_y = 23
	},
/obj/structure/machinery/cm_vending/sorted/medical/vehicle{
	pixel_x = 2;
	pixel_y = 23
	},
/obj/effect/decal/medical_decals/permanent{
	icon_state = "triagedecaltop";
	pixel_y = -2
	},
/obj/effect/decal/medical_decals/permanent{
	icon_state = "triagedecalbottomright"
	},
/obj/structure/machinery/iv_drip,
/turf/open/shuttle/vehicle/dark_sterile_green_13,
/area/interior/vehicle/apc)
"aO" = (
/obj/structure/surface/table/reinforced/toc/east{
	pixel_y = 4;
	density = 0
	},
/obj/effect/landmark/interior/spawn/telephone/toc{
	pixel_x = 11;
	pixel_y = 23
	},
/obj/structure/bed/chair/vehicle/white{
	dir = 1;
	pixel_x = -16;
	pixel_y = -4
	},
/obj/structure/machinery/prop/almayer/CICmap/toc{
	pixel_y = 23;
	pixel_x = -7
	},
/turf/open/shuttle/vehicle/floor_3_11,
/area/interior/vehicle/apc)
"aP" = (
/obj/structure/machinery/medical_pod/bodyscanner{
	pixel_y = 4;
	pixel_x = -8
	},
/turf/open/shuttle/vehicle/med,
/area/interior/vehicle/apc)
"aQ" = (
/obj/effect/decal/medical_decals/permanent{
	dir = 4;
	icon_state = "triagedecaldir"
	},
/obj/structure/machinery/body_scanconsole{
	pixel_x = -8
	},
/turf/open/shuttle/vehicle/dark_sterile_green_8,
/area/interior/vehicle/apc)
"aS" = (
/turf/open/shuttle/vehicle/floor_1_14,
/area/interior/vehicle/apc)
"aU" = (
/turf/open/shuttle/vehicle/floor_1_6,
/area/interior/vehicle/apc)
"aV" = (
/obj/structure/machinery/medical_pod/autodoc/unskilled{
	name = "\improper autodoc emergency medical system";
	dir = 1;
	pixel_y = 4;
	pixel_x = -8
	},
/turf/open/shuttle/vehicle/med,
/area/interior/vehicle/apc)
"aW" = (
/turf/open/shuttle/vehicle/floor_1_5,
/area/interior/vehicle/apc)
"aX" = (
/obj/structure/surface/table/reinforced/prison,
/obj/structure/machinery/recharger,
/obj/item/device/defibrillator,
/turf/open/shuttle/vehicle/floor_3,
/area/interior/vehicle/apc)
"aY" = (
/obj/effect/landmark/interior/spawn/vehicle_driver_seat/armor{
	dir = 4
	},
/turf/open/shuttle/vehicle/floor_3_9_1,
/area/interior/vehicle/apc)
"ba" = (
/obj/effect/landmark/interior/spawn/entrance{
	alpha = 50;
	exit_type = /obj/structure/interior_exit/vehicle/apc;
	name = "Right APC door";
	tag = "right"
	},
/obj/effect/landmark/interior/spawn/interior_viewport{
	dir = 8;
	pixel_x = 5;
	pixel_y = 1
	},
/turf/open/shuttle/vehicle/floor_1_12,
/area/interior/vehicle/apc)
"bc" = (
/turf/open/shuttle/vehicle/floor_3_13,
/area/interior/vehicle/apc)
"bd" = (
/obj/structure/interior_wall/apc{
	alpha = 100;
	icon_state = "door_front";
	layer = 5.2;
	pixel_y = 32
	},
/turf/open/void/vehicle,
/area/space)
"be" = (
/obj/structure/interior_wall/apc{
	alpha = 100;
	icon_state = "wall_door_front";
	layer = 5.2;
	pixel_y = 32
	},
/turf/open/void/vehicle,
/area/space)
"fq" = (
/obj/effect/landmark/interior/spawn/interior_viewport{
	dir = 8;
	pixel_x = 5;
	pixel_y = 8
	},
/obj/effect/landmark/interior/spawn/entrance{
	alpha = 50;
	dir = 1;
	exit_type = /obj/structure/interior_exit/vehicle/apc;
	name = "Left APC door";
	pixel_y = 32;
	tag = "left"
	},
/obj/structure/barricade/handrail{
	dir = 8;
	pixel_x = -2;
	pixel_y = 7
	},
/turf/open/shuttle/vehicle/floor_1_11,
/area/interior/vehicle/apc)
"kv" = (
/obj/structure/machinery/sentry_holder/almayer/mini{
	base_icon_state = "nothing";
	icon_state = "nothing";
	icon = 'icons/effects/effects.dmi';
	name = "hidden lever";
	require_red_alert = 0;
	desc = "A some kind of toggle, well integrated into floor design."
	},
/turf/open/shuttle/vehicle/floor_0_1_15,
/area/interior/vehicle/apc)
"oO" = (
/obj/structure/bed/chair/vehicle{
	dir = 8;
	pixel_x = 2;
	pixel_y = 16
	},
/obj/structure/bed/chair/vehicle{
	dir = 8;
	pixel_x = 2
	},
/turf/open/shuttle/vehicle/floor_3_9_1,
/area/interior/vehicle/apc)
"rQ" = (
/obj/structure/interior_wall/apc{
	icon_state = "wheel_front_top_2";
	pixel_x = 4;
	pixel_y = -4
	},
/obj/structure/interior_wall/apc{
	icon_state = "corner_small_R";
	opacity = 0
	},
/turf/open/void/vehicle,
/area/space)
"HL" = (
/obj/structure/machinery/autodoc_console{
	pixel_x = -8
	},
/obj/effect/decal/medical_decals/permanent{
	icon_state = "triagedecalbottom"
	},
/obj/effect/decal/medical_decals/permanent{
	icon_state = "triagedecaltopright"
	},
/obj/structure/bed/roller,
/turf/open/shuttle/vehicle/dark_sterile_green_14,
/area/interior/vehicle/apc)
"Nl" = (
/obj/structure/bed/chair/vehicle{
	dir = 8;
	pixel_x = 2;
	pixel_y = 16
	},
/obj/structure/bed/chair/vehicle{
	dir = 8;
	pixel_x = 2
	},
/turf/open/shuttle/vehicle/floor_3_8_1,
/area/interior/vehicle/apc)
"Rb" = (
/obj/structure/interior_wall/apc{
	icon_state = "wall_door_front"
	},
/turf/open/void/vehicle,
/area/space)
"Ty" = (
/obj/effect/landmark/interior/spawn/vehicle_support_gunner_seat/second,
/obj/structure/prop/vehicle/firing_port_weapon{
	layer = 4.1;
	name = "Right M56 FPW handle";
	pixel_y = 2
	},
/turf/open/shuttle/vehicle/floor_3_12,
/area/interior/vehicle/apc)
"YB" = (
/obj/structure/interior_wall/apc{
	icon_state = "wall";
	alpha = 100;
	layer = 5.2;
	pixel_y = 32
	},
/turf/open/void/vehicle,
/area/space)

(1,1,1) = {"
aa
aj
ap
ar
at
av
aD
"}
(2,1,1) = {"
ab
ak
aK
aP
aV
aw
aD
"}
(3,1,1) = {"
ac
al
aL
aQ
HL
ax
aD
"}
(4,1,1) = {"
Rb
aF
az
ay
ae
aX
be
"}
(5,1,1) = {"
ad
aO
oO
aW
Nl
Ty
YB
"}
(6,1,1) = {"
ag
fq
aU
kv
aU
ba
bd
"}
(7,1,1) = {"
rQ
an
aE
aS
bc
aA
aD
"}
(8,1,1) = {"
ah
ak
am
aH
aY
aB
aD
"}
(9,1,1) = {"
ai
ao
aq
as
au
aC
aD
"}
